year_index,report_year,utility_id_eia,utility_name_eia,ownership_code,ownership,monthly,short_form,advanced_metering,delivery_company,demand_response,distribution_systems,dynamic_pricing,energy_efficiency,mergers,has_net_metering,non_net_metering_distributed,operational_data,reliability,sales_to_ultimate_customers,service_territory,utility_data,early_release
2016,0,1,2,3,4,-1,5,6,-1,7,8,9,10,11,12,13,14,15,16,17,18,-1
2017,0,1,2,3,4,5,6,7,-1,8,9,10,11,12,13,14,15,16,17,18,19,-1
2018,0,1,2,3,4,5,6,7,-1,8,9,10,11,12,13,14,15,16,17,18,19,-1
2019,0,1,2,4,5,6,3,7,-1,8,9,10,11,12,13,14,15,16,17,18,19,-1
2020,0,1,2,4,5,6,3,7,8,9,10,11,12,13,14,15,16,17,18,19,20,-1
2021,0,1,2,4,5,6,3,7,8,9,10,11,12,13,14,15,16,17,18,19,20,-1
2022,0,1,2,4,5,6,3,7,8,9,10,11,12,13,14,15,16,17,18,19,20,-1
2023,0,1,2,4,5,6,3,7,8,9,10,11,12,13,14,15,16,17,18,19,20,-1
