year_index,boiler_generator_assn,utility,ownership,plant,generator_existing,generator_proposed,generator_retired
2009,0,0,0,0,0,1,2
2010,0,0,0,0,0,1,2
2011,0,0,0,0,0,1,2
2012,0,0,0,0,0,1,2
2013,0,0,0,0,0,1,2
2014,0,0,0,0,0,1,2
2015,0,0,0,0,0,1,2
2016,0,0,0,0,0,1,2
2017,0,0,0,0,0,1,2
2018,0,0,0,0,0,1,2